1 1 1 1 1 1 1 1 1 1
1 0 0 0 0 0 b 0 1 1
1 p 1 s 1 s 1 0 1 1
1 1 1 0 0 b s s 1 1
1 1 1 s 1 s 1 0 2 1
1 1 1 0 s s 0 3 1 1
1 1 1 1 1 1 1 k 1 1
1 1 1 1 1 1 d t 1 1
1 1 1 1 1 1 1 1 1 1