1 1 1 1 1 1 1 1 1
1 0 b 0 b 0 0 p 1
1 0 b 0 0 b 0 1 1
1 2 0 1 1 1 1 1 1
1 1 3 s 0 s 1 1 1
1 1 0 0 s k t 1 1
1 1 1 1 1 1 d 1 1
1 1 1 1 1 1 1 1 1

