1111111111
1020030001
1000000001
10p000b001
100000b001
10s0000001
10s0000001
1000000t01
10k0000td1
1111111111