1 1 1 1 1 1 1 1 1
1 1 d 1 1 p s 1 1
1 0 t 1 1 s 0 1 1
1 0 0 1 1 0 b 0 1
1 0 b 1 1 k k 2 1
1 1 3 1 0 b 0 0 1
1 1 0 0 0 k 1 1 1
1 1 1 1 1 1 1 1 1